--R-------
-------B--
-----G----
--Y-------
------R---
----Y-----
-------W--
----G-----
-------M--
-----R----


					