--R-------
-------G--
----B-----
----------
----W-----
----------
----------
Y---------
---------C
-----W----
----------
----------
-------R--
----R---R-
----------
-R--R----R
----------
----------
----Y-----
Y---------
----------
-------C--
----C---M-
----------
-G--------