--R-------
------R---
---R----R-
---B------
----------
------R---
--------B-
------G---
----B-----
--G----B--
----------
----G-----
--R-------
-----G----
--G-------
------B---
--------G-
------G---