-R--------
-R--------
-R------B-
-R------B-
-R---W--B-
-R---W--B-
-R---W--B-
-R---W--B-
-R---W--B-
-R--------
-R--------
-R------B-
-R------B-
-R---W--B-
-R---W--B-
-R---W--B-
-R---W--B-
-R---W--B-
-R--------
--R-------
---R------
----R-----
-----R----
------R---
-------R--