-R----G--Y
--------B-
---W------
--------B-
-G--------

					